@################
...##.##.######
##########.##.##
##..##.##.##.##
##.##.##.##.###
##.##..##.##.##
##.##########.##
##....##.######
##################
###############
###############
###############
###############
###############
###############
